M-#------------
#-#-####-#####-
#-#-#----#-----
#-#-#########--
#-#-##------#-#
#-------#####-#
#-------------#
--#############
----#----------
-####--########
-------#-------
-###########---
-------------#G
######-#######-
-------------#1