M-#------------
#-#-####-#####-
#-#-#----#-----
#-#-#########--
#-#---------#-#
#-------#####-#
#-------------#
--#############
----#----------
-####--########
-------#-------
-###########---
---------------
######-#######G
-------------#1