M-#------------
#-#-####-#####-
#-#-#----#-----
#---#########--
#-#####-----#-#
#-#####-#####-#
#-------------#
--#############
----#----------
-####-#########
------##-------
-###########---
-------------#-
######-#######G
-------------#1